####################
#P..#T.#....T#T....X
#...##.###.####.####
#............#..#..#
#.......#....#..#..#
#.############..#..#
#......#....##..#..#
#..#...##.#..#..#..#
#..#...#..##.#..#..#
#...#..#.##..#..#..#
#.#..#....#.##.###.#
#.#...#...#..#.#...#
#.#....#..##.#.#.#.#
#.#######.#..#.#.#.#
#...T.#..###.#...#.#
#######...#..####..#
#............#..#..#
#.###.#####.##..#..#
#.......T#.....T...#
####################