####################
#PB#F....#.........#
#B.#...........B.B.#
#F.###....##########
#.........#.......F#
########.#...#######
#...........B.#....#
#####.......#F#....#
#.....#######.######
#.............#F#..#
########..#...#.#B.#
#.........#...#....#
#...#####.#...#....#
#.........#...#....#
#B######..#...#....#
##BBBBB...#..B#....#
#.FFF.....#..F.....#
#.BBB.....#........#
#.........#........#
####################