####################
#P.#....S#.........#
#..#M.####.........#
#..##.....##########
#.........#.......E#
########..#..#######
#C............#.C..#
#####.........#....#
#.....#######.######
#.............#....#
#.........#...#..E.#
#.........#...#....#
#....####.#...#....#
#.........#...#....#
#.........#...#....#
#..#####..#...#....#
#.........#........#
#....A....#........#
#.........#........#
####################