####################
X...#S.#T....#.....#
#...##.###E####.####
#............#..#TA#
#######O..####..#..#
#..........###..#..#
#......#....##..#..#
#...#..##.#..#..#..#
#...#..#..##.#..#..#
#...#..#.##..#..#..#
#.#.##....#.##.###.#
#.#.E###..#..#.#...#
#.#..T.#..##.#.#.#.#
#.######..#..#.#.#.#
#.....#..###.#...#.#
#######..O#..####..#
#..........BF#..#..#
#.###.#####.##..#..#
#P.......#.........#
####################