####################
#P.#....C#.........#
#..#M.####.........#
#..##.....##########
#.........#.......S#
########..##########
#.............#...K#
#######.......#...O#
#.....#.......######
#.....#.......#....#
#.##D##...#...#....#
#.#O.A#####...#....#
#.#...#.......#....#
#.#####.......#....#
#....O#.......#....#
###############....#
#...............O..#
####.......#####...#
#..................#
##########X#########